easy#1
2 0 0 4 0 0 1 0 0
0 0 0 0 1 0 0 0 3
3 0 0 7 0 4 0 2 0
0 0 0 0 0 0 0 0 3
2 0 0 7 0 8 0 4 0
0 0 0 0 0 0 0 0 2
0 1 0 4 0 5 0 2 0
2 0 0 0 1 0 0 0 0
0 0 1 0 0 3 0 0 2
easy#2
0 1 0 3 0 3 0 0 2
3 0 2 0 2 0 0 1 0
0 1 0 4 0 0 4 0 5
0 0 0 0 0 0 0 0 0
3 0 0 3 0 4 0 1 0
0 0 0 0 0 0 1 0 4
4 0 0 7 0 5 0 1 0
0 0 0 0 1 0 0 0 2
2 0 0 4 0 0 1 0 0
easy#3
1 0 3 0 0 3 0 2 0
0 0 0 0 0 0 0 0 1
4 0 5 0 5 0 0 5 0
0 2 0 1 0 0 0 0 0
2 0 1 0 4 0 1 0 3
0 0 0 0 0 1 0 5 0
0 3 0 0 3 0 1 0 3
1 0 1 0 0 2 0 3 0
0 3 0 3 0 0 2 0 2
